111111111111
1001011010e1
101100100011
100001010111
111100000101
101110110101
100100000001
110111010011
100110010111
110000100001
111001101001
11s000001001
111111111111
